'0','0','0','0','7','0','0','7','0','4','0','0','0','0','0',
'0','0','0','0','7','0','0','8','0','8','0','7','0','0','0',
'0','0','7','0','0','0','0','0','7','8','8','8','0','0','0',
'7','0','0','7','0','0','3','7','0','6','0','0','0','0','0',
'0','7','0','0','0','0','7','0','0','8','0','0','0','0','0',
'0','0','0','0','0','2','7','7','7','8','0','0','0','0','0',
'0','0','0','7','0','0','0','0','8','0','0','0','0','0','0',
'7','7','7','0','0','3','7','4','7','0','0','0','0','0','0',
'0','0','0','0','0','0','7','0','0','0','0','0','0','0','0',
'0','0','0','7','0','0','0','7','0','0','0','0','0','0','0'